{
  "name": "Surge Corridor",
  "timeLimitSec": 115,
  "playerSpawn": { "x": 2, "y": 10 },
  "checkpoint": { "x": 30, "y": 5 },
  "enemySpawns": [
    { "x": 14, "y": 10, "left": 10, "right": 18, "speed": 3.2 },
    { "x": 35, "y": 4, "left": 31, "right": 39, "speed": 3.5 },
    { "x": 50, "y": 8, "left": 46, "right": 54, "speed": 3.8 }
  ],
  "boss": null,
  "map": [
    "############################################################",
    "#                                                          #",
    "#                                          *               #",
    "#                                     ==========           #",
    "#         *           ^^                                    #",
    "#      ========   ==========  C                             #",
    "#                                ====                      #",
    "#                  ^^^^              ^^^^                   #",
    "#            ====          ====          ====    *          #",
    "#   ^^^^                                    =========  E   #",
    "#                                                          #",
    "#=======       ====    ====    ====                         #",
    "#                                                          #",
    "#                                                          #"
  ]
}
