{
  "name": "Voltage Maze",
  "timeLimitSec": 120,
  "playerSpawn": { "x": 2, "y": 4 },
  "checkpoint": { "x": 30, "y": 8 },
  "enemySpawns": [
    { "x": 12, "y": 4, "left": 8, "right": 16, "speed": 3.0 },
    { "x": 25, "y": 8, "left": 21, "right": 30, "speed": 3.4 },
    { "x": 40, "y": 4, "left": 36, "right": 46, "speed": 3.7 },
    { "x": 52, "y": 8, "left": 48, "right": 56, "speed": 4.0 }
  ],
  "boss": null,
  "map": [
    "############################################################",
    "#                                                          #",
    "#  *             ^^^^              *          ^^^^          #",
    "#                                                          #",
    "#                                                          #",
    "#=======   ==========   ==========   ==========   ===      #",
    "#                                                          #",
    "#          ^^^^             ^^^^            ^^^^            #",
    "#                                                          #",
    "#      ==========  C  ==========   ==========  ======  E  #",
    "#                                                          #",
    "#                                                          #",
    "#                                                          #",
    "#                                                          #"
  ]
}
