{
  "name": "Tyrant Nexus",
  "timeLimitSec": 160,
  "playerSpawn": { "x": 3, "y": 10 },
  "checkpoint": { "x": 22, "y": 9 },
  "enemySpawns": [
    { "x": 16, "y": 10, "left": 12, "right": 20, "speed": 3.0 }
  ],
  "boss": {
    "x": 44,
    "y": 9,
    "health": 10,
    "phaseSpeed": [1.8, 3.1]
  },
  "map": [
    "############################################################",
    "#                                                          #",
    "#                                                          #",
    "#         *                                                #",
    "#      ========                                            #",
    "#                                                          #",
    "#                         C                                #",
    "#                    ============                          #",
    "#                                                          #",
    "#                             ^^^^^^^                      #",
    "#                                                          #",
    "#=============                  =========            E      #",
    "#                                                          #",
    "############################################################"
  ]
}
