{
  "name": "Tyrant Core",
  "timeLimitSec": 180,
  "playerSpawn": { "x": 3, "y": 10 },
  "checkpoint": { "x": 20, "y": 10 },
  "enemySpawns": [
    { "x": 15, "y": 10, "left": 10, "right": 20, "speed": 3.5 },
    { "x": 50, "y": 10, "left": 44, "right": 55, "speed": 3.5 }
  ],
  "boss": {
    "x": 40,
    "y": 8,
    "health": 20,
    "phaseSpeed": [2.0, 3.5, 5.0],
    "size": 2
  },
  "map": [
    "############################################################",
    "#                                                          #",
    "#       *                    *                 *            #",
    "#                                                          #",
    "#                                                          #",
    "#                                                          #",
    "#    ^^^^         ^^^^              ^^^^         ^^^^       #",
    "#                                                          #",
    "#                                                          #",
    "#                                                          #",
    "#                                                       E  #",
    "#==========  C  ========================================== #",
    "#                                                          #",
    "#                                                          #"
  ]
}
