{
  "name": "Ingress Grid",
  "timeLimitSec": 120,
  "playerSpawn": { "x": 2, "y": 10 },
  "checkpoint": { "x": 24, "y": 9 },
  "enemySpawns": [],
  "boss": null,
  "map": [
    "############################################################",
    "#                                                          #",
    "#                                                          #",
    "#          *                              *                #",
    "#       ========                     ========              #",
    "#                                                          #",
    "#                    ^^^^^                                 #",
    "#             ========                                     #",
    "#                                  C                       #",
    "#                             ============                 #",
    "#  @                                                       #",
    "#=============================              ========   E   #",
    "#                                                          #",
    "############################################################"
  ]
}
