{
  "name": "Pulse Tunnels",
  "timeLimitSec": 125,
  "playerSpawn": { "x": 2, "y": 10 },
  "checkpoint": { "x": 31, "y": 7 },
  "enemySpawns": [
    { "x": 18, "y": 10, "left": 12, "right": 24, "speed": 2.6 }
  ],
  "boss": null,
  "map": [
    "############################################################",
    "#                                                          #",
    "#            *                                             #",
    "#      ========                         ========           #",
    "#                                                          #",
    "#                ^^^^^^^                                   #",
    "#         ========              C                          #",
    "#                               =========                  #",
    "#                                                          #",
    "#                            *                             #",
    "#                                                          #",
    "#=================                 ========          E     #",
    "#                                                          #",
    "############################################################"
  ]
}
