{
  "name": "Phantom Breach",
  "timeLimitSec": 140,
  "playerSpawn": { "x": 3, "y": 10 },
  "checkpoint": { "x": 25, "y": 7 },
  "enemySpawns": [
    { "x": 18, "y": 10, "left": 14, "right": 22, "speed": 3.4 },
    { "x": 42, "y": 6, "left": 38, "right": 48, "speed": 3.4 }
  ],
  "boss": {
    "x": 48,
    "y": 8,
    "health": 6,
    "phaseSpeed": [2.0, 3.2],
    "size": 1
  },
  "map": [
    "############################################################",
    "#                                                          #",
    "#       *                                   *              #",
    "#    ========                          ==========          #",
    "#                    ^^^^                                   #",
    "#              ============                                 #",
    "#                              ^^^^                         #",
    "#                         C =========                      #",
    "#         ^^^^                              ==========  E  #",
    "#                                                          #",
    "#                                                          #",
    "#==========    =====     =====    =====                    #",
    "#                                                          #",
    "#                                                          #"
  ]
}
