{
  "name": "Deadlock Spire",
  "timeLimitSec": 110,
  "playerSpawn": { "x": 2, "y": 10 },
  "checkpoint": { "x": 28, "y": 3 },
  "enemySpawns": [
    { "x": 10, "y": 10, "left": 6, "right": 14, "speed": 3.6 },
    { "x": 22, "y": 7, "left": 18, "right": 26, "speed": 3.8 },
    { "x": 38, "y": 4, "left": 34, "right": 44, "speed": 4.0 },
    { "x": 52, "y": 8, "left": 48, "right": 56, "speed": 4.2 }
  ],
  "boss": null,
  "map": [
    "############################################################",
    "#                                                          #",
    "#                        *    *                             #",
    "#                   C ============                          #",
    "#    ^^^^                             ^^^^     *            #",
    "#             =====                       ==========   E   #",
    "#  *                    ^^^^                                #",
    "#                                                          #",
    "#      =====    ============    =====                      #",
    "#  ^^^^              ^^^^              ^^^^                 #",
    "#                                                          #",
    "#=======    =====              =====    ============        #",
    "#                                                          #",
    "#                                                          #"
  ]
}
