{
  "name": "Core Chokepoint",
  "timeLimitSec": 135,
  "playerSpawn": { "x": 2, "y": 10 },
  "checkpoint": { "x": 30, "y": 6 },
  "enemySpawns": [
    { "x": 14, "y": 10, "left": 10, "right": 20, "speed": 3.2 },
    { "x": 28, "y": 8, "left": 24, "right": 34, "speed": 3.0 },
    { "x": 46, "y": 6, "left": 40, "right": 52, "speed": 3.4 }
  ],
  "boss": null,
  "map": [
    "############################################################",
    "#                                                          #",
    "#              *                                           #",
    "#     ========                      ========               #",
    "#                                                          #",
    "#         ^^^^^^^^           C                            #",
    "#                     ===========                          #",
    "#                                                          #",
    "#                              ^^^^^^^                     #",
    "#             ========                       ========      #",
    "#                                                          #",
    "#========              *               ========      E     #",
    "#                                                          #",
    "############################################################"
  ]
}
