{
  "name": "Drone Shaft",
  "timeLimitSec": 130,
  "playerSpawn": { "x": 3, "y": 10 },
  "checkpoint": { "x": 34, "y": 5 },
  "enemySpawns": [
    { "x": 16, "y": 9, "left": 12, "right": 24, "speed": 3.0 },
    { "x": 42, "y": 6, "left": 36, "right": 50, "speed": 2.8 }
  ],
  "boss": null,
  "map": [
    "############################################################",
    "#                                                          #",
    "#                           *                              #",
    "#                ========                                  #",
    "#         ^^^^^                                            #",
    "#                     ========   C                         #",
    "#                                                          #",
    "#         ========                      ========           #",
    "#                                                          #",
    "#                           ^^^^^^^                        #",
    "#                                                          #",
    "#===========       *                  ========       E     #",
    "#                                                          #",
    "############################################################"
  ]
}
